#################
#    #        # #
#          #  # #
#####   #  # ## #
#       ## #    #
##  ### #  ##  ##
#  ###          #
#      #        #
##############*##