##########################################################################
#   #                           #    #              #                #   #
#   #  #### ## ## ### ## ### ## ## ### # ## #### ## ## ### ## ### ## #   #
#      #       #      #    # #     # #    # #              #    # #      #
###    # # # ### ### ## ## #       #     ## # # # ### ### ## ## #      ###
#   #  # #     #        #  # #    ####      # #     #        #  # ##     #
####     ### # #####  # ## # # ## #   # ## # #         ######## # #  #   #
# #      #   #  #          # #  # # ## ##     ### # #####  # ## # # ## # #
# ### # ## #### # ### ## ### #    #           #   #              #       #
#     #    # #  #   #      #   ## # ### ## # #         ###  ### # #  #   #
## ## # #         ######## # #  #          #    # #  #          #   ## # #
#   # # # #### #         # # ## ## # # # # ## ### #   #   # ##### ## #####
# # # #      # ### ### #   #  #     ##      #   # #            #         #
# # # ## ### #   #   # ##### ## ####### ## # ##     #  ######## # #  #   #
#     #      # #   #         #             #   # #            #      #   #
# ### #  ### ###  ####### ##### ######        #     #            #       |
#          # #                      #  ## # #   # #  ######### # #  ##   #
#### # # ### # ####  #### ### ### ####      #   # #            # #     ###
#      #   # #            #          ###    # # # # ####  #### ####      #
#   # ## # # ### # #  ##### ####### ## # # ## ### #   #   #  ###    ##   #
#   #    #       #          #        #        #         #         #  #   #
##########################################################################
